
### For Difference check ###

DIFF_Gauge_confs_list1	= ./arg/conf_list/conf_list.pacs-cs_ens2_10confs
DIFF_Gauge_confs_list2	= ./arg/conf_list/conf_list.pacs-cs_ens2
DIFF_Path_to_input_dir1	= /Users/miiya/Desktop/work_kyoto/test_data/pacs-cs_ens2_comp_10conf
DIFF_Path_to_input_dir2	= /Users/miiya/Desktop/work_kyoto/test_data/pacs-cs_ens2_comp_10conf
DIFF_Size_of_time	= 64
DIFF_Size_of_space	= 32
DIFF_T_shift		= 000
DIFF_X_shift		= 000
DIFF_Y_shift		= 000
DIFF_Z_shift		= 000
DIFF_Snk_relativistic	= CG05
DIFF_Src_relativistic	= CG05
DIFF_Min_time_slice	= 6
DIFF_Max_time_slice	= 8
DIFF_Hadron_directory	= { PS SS }
DIFF_Calc_hadron_name	= { pion phi proton Lambda Sigma }
DIFF_Calc_channel_name	= { Pro-Neu_Pro-Neu Pro-Lam_Pro-Lam Pro-Lam_Pro-SigZ Pro-Lam_Neu-SigP Pro-SigZ_Pro-Lam Pro-SigZ_Pro-SigZ Pro-SigZ_Neu-SigP Neu-SigP_Pro-Lam Neu-SigP_Pro-SigZ Neu-SigP_Neu-SigP }
DIFF_Calc_2hadron_corr	= no

DIFF_Endian_convert	= yes
DIFF_read_compress_NBS	= yes

DIFF_Computer_eps	= 1e-30
DIFF_Precition		= 1e-3
